21 21
0  0  0  0  0  0  0  0  0  0  0  0  0  7  0  0  0  0  0  0  0
7  0  1  4  0  2  3  0  7  8  7  9  0  2  0  3  2  1  7  8  9
9  0  8  0  0  2  0  0  0  0  4  4  4  4  0  5  0  0  0  6  7
9  0  0  0  6  8  0  4  4  0  1  2  5  7  0  5  0  3  0  1  0
12 1  0  0  0  7  0  5  8  0  0  0  0  0  0  9  0  4  0  2  0
3  0  0  5  3  0  0  0  0  7  8  7  0  5  0  0  0  5  0  3  0
9  0  4  6  0  0  1  2  0  2  0  4  7  0  6  4  0  4  0  7  0
9  0  9  0  8  0  3  4  0  0  0  0  0  0  2  6  0  2  0  0  0
1  0  0  0  8  0  5  6  0  7  2  3  5  0  4  3  6  4  0  4  0
2  0  6  0  8  0  0  0  0  0  0  4  5  0  0  0  0  0  0  5  0
0  0  0  0  0  0  1  2  1  1  0  0  0  1  3  4  2  5  9  5  0
4  3  4  0  3  5  4  0  0  0  0  6  0  6  7  8  9  1  1  6  0
3  4  3  0  2  3  4  6  8  3  9  5  0  15 0  0  0  2  1  3  0
0  0  0  0  0  0  0  0  0  0  0  4  0  8  8  3  0  0  0  0  0
0  5  5  5  5  6  6  7  1  3  0  3  0  0  8  0  9  0  2  3  0
0  0  0  0  7  2  0  0  0  0  0  2  0  9  1  1  3  0  5  1  0
7  3  3  0  5  8  0  3  5  0  3  1  0  3  2  0  1  0  4  0  0
0  0  0  0  0  9  0  7  8  0  5  0  0  0  0  0  2  0  7  3  0
0  1  3  2  5  4  0  0  4  5  2  4  0  3  2  8  9  6  5  3  0
0  0  0  0  0  0  7  0  0  0  0  0  0  0  0  0  0  0  0  1  0