16 16
0  0  0  0  0  0  0  0  0  0  0  0  0  0  0  0
0  1  9  0  5  6  7  8  9  0  1  6  1  6  1  0
0  2  0  0  0  0  0  0  0  0  0  0  0  0  1  0
0  3  0  2  4  2  4  2  4  2  4  2  4  0  6  0
0  4  0  2  0  0  0  0  0  0  0  0  2  0  1  1
0  5  0  2  0  1  3  1  3  0  1  0  4  0  6  0
0  6  0  4  2  1  0  0  0  0  3  0  2  0  1  0
0  7  0  2  0  3  0  15 0  0  1  0  4  0  6  0
0  8  1  4  0  1  0  0  11 0  3  0  2  0  1  0
0  9  0  2  0  3  0  0  0  0  3  0  0  0  6  0
0  1  0  4  0  1  1  3  1  1  3  0  7  0  1  0
0  1  0  2  0  0  0  0  0  0  0  0  4  0  6  0
0  6  0  2  4  2  4  2  4  2  4  2  2  0  1  0
0  1  0  0  0  0  0  0  0  0  0  0  0  0  6  0
0  1  6  1  6  1  6  1  6  1  6  1  6  1  1  0
0  0  0  0  0  0  0  0  0  0  0  0  0  0  0  0